█████████████████████████████████████████████████████████████████████████████████████████████████████████████████████████████████████████████
█             █                 █               █                 █       █           █       █                 █     █   █             █OOO█
█ ███████████ █ █████████ █ █████ █ ███████ █████ █████████████ ███ █████ █ █████████ █ █ ███ █ █████ ███████████ ███ █ █ █ █████ ███████O█ █
█         █ █   █   █   █ █     █ █               █           █ █       █           █   █   █ █ █   █ █         █ █ █ █ █      OOOOOOOOOOO█ █
█████████ █ ███████ █ █ ███ ███ █ █ █ █ █ ███ █████████ █ █████ █ █████████ ███████ ███████ █ █ ███ █ █ ███████ █ █ █ ███ █ █ █O█ █ ███████ █
█     █ █ █         █ █         █ █   █ █ █ █ █         █ █   █ █ █ █         █   █ █   █   █ █     █     █     █              O    █ █   █ █
███ █ █ █ █ ███████ █ █████ █████ █████ █ █ █ ███ █████████ █ █ █ █ █ █████ █ █ █ █ █ █ █ ███ █████ ███████ █ █████ ███ █ █ █ █O███ █ █ █ █ █
█   █   █   █                         █ █   █     █   █     █ █ █ █ █ █     █ █ █ █   █ █ █ █ █   █ █   █   █ █       █ █     █O      █ █   █
█ ███ █████ █ ███ █████ █████ █████████ █████████ █ █ █ █████ █ █ █ █ █ █ █ █ █ █ ███████ █ █ █ █ █ ███ █ █████ ███████ ███████O███████ █████
█ █   █         █   █                         █   █ █   █       █ █ █ █ █     █ █     █   █ █ █ █   █   █     █   █     █     █OOOOO█   █   █
█ █████ ███████ ███ █ ███ █████ █████ █ █ ███ █ ███ ███ █████ ███ █ █ █████ ███ █████ █ ███ █ █ █████ ███████ ███ █ █████ ███ █████O█ ███ █ █
█ █       █     █   █     █   █   █                 █   █   █ █   █ █     █ █   █     █ █   █ █     █     █     █ █       █ █ █   █OOOOOOOOO█
█ █ ███████ █████ █████████ █ ███ ███ █ █ █ █ █ █ ███████ █ █ █ ███ █████ █ ███ █ █████ ███ █ █████ ███ █ █ ███ █ █ ███████ █ ███ █ █ █ ███O█
█     █     █   █         █ █   █   █     █ █   █     █   █ █ █       █   █     █   █     █ █   █ █     █ █   █ █ █         █   █   █   █OOO█
█ █ █ █ █ ███ █ █████████ █ █ █ ███ █████ █ █████████ █ ███ █████████ █ ███ ███████ █████ █ ███ █ ███████ ███ ███ █ █ █████ ███ █████████O█ █
█ █   █ █ █   █     █     █ █ █   █     █     █   █   █   █         █   █         █       █   █ █   █     █ █     █       █   █   █   █OOO█ █
█ ███ █ ███ █████ ███ █████ █ █████████ █ ███ █ ███ ███ █████ █ █ ███ █ ███ ███ ███████████ █ █ ███ █ █████ ███ █ █ █████ █ █████ █ █ █O███ █
█ █   █         █ █   █     █     █     █   █ █   █ █   █     █   █   █       █       █     █ █ █   █ █       █   █ █   █ █     █   █ █OOO█ █
█ █ █████████████ █ ███████ █████ █ █████ █ █ █ █ █ █ ███ ███ █████ █████████ ███ ███ █ ███ ███ █ █ █ █████ ███████ █ █ ███████ █████ █ █O█ █
█   █                     █     █ █       █ █ █ █ █   █   █ █ █   █ █       █   █ █ █     █   █   █ █     █     █   █ █         █   █ █ █O█ █
█ █ █ █████████ █████ ███ ███████ ███ █████ █ █ █ █████ ███ █ █ █ █ █ █ ███████ █ █ █████ ███ █ █████████ ███ █ █ ███ ███████ █ █ ███ ███O███
█ █ █ █       █         █                 █   █ █   █ █ █ █     █   █ █   █     █   █       █   █   █   █   █ █   █   █       █ █   █   █OOO█
█ █ █ ███████ █████████ █████ ███████████████ █ █ █ █ █ █ █ ███ █████ ███ █ ███ ███ ███ █ ███████ █ █ █ ███ █ █████ ███ █ █████ ███ █ █ █ █O█
█                     █ █     █   █         █ █ █ █ █ █     █   █   █ █   █ █     █   █ █     █   █   █     █ █   █ █ █ █     █   █   █ █ █O█
███ █ █ ███ █ █ █████ █ █ ███ █ █ █ ███████ █ ███ █ █ █ █ ███ ███ █ ███ █ █ █ ███████ █ ███ █ █ ███████████████ █ █ █ █ █████ ███ █ █ █ ███O█
█   █ █ █       █     █     █   █   █     █ █     █   █ █ █ █ █   █   █ █ █ █         █ █   █ █   █             █   █       █       █ █   █O█
█ █ █ █ █ █ █████ ███ █████ █████████ █ ███ █████ █████ █ █ █ █ █ ███ █ ███ █████ ███ ███ ███ ███ █ ███ █ █ █████████ ███████████████ ███ █O█
█   █   █ █     █ █     █             █ █   █     █     █ █ █ █ █   █ █   █     █   █     █ █ █ █   █   █ █       █ █   █       █   █ █ █ █O█
███ █ ███ █████ █ █████ █ █████ █ ███████ ███ █████ █████ █ █ █████ █ █ █ █████ █ █ ███████ █ █ █████ ███ ███████ █ ███ █ █████ █ █ █ █ █ █O█
█ █     █ █   █ █     █ █ █     █ █       █   █   █ █   █   █       █ █ █     █   █     █     █   █ █   █ █     █ █ █   █   █ █ █ █     █ █O█
█ █ █ █ █ █ █ █ █████ █ █ █ █████ █ ███████████ █ █ ███ ███ █████████ █████ █ █████████ █ █████ █ █ ███ █ ███ ███ █ █ ███ █ █ █ ███████ █ █O█
█       █ █ █ █     █ █ █ █     █ █     █       █   █   █   █       █ █   █ █     █     █ █     █   █   █ █   █   █   █     █         █ █ █O█
█ █ █ ███ █ █ █ ███ █ ███ █████ █ █████ █ █████████ █ █ █ ███ ███████ █ █ █ █ █████ █████ █ ███████ █ ███ █ █ █ ███ ███ █████████████ █ █ █O█
█   █     █ █     █ █   █   █ █ █ █   █   █           █ █   █       █   █   █ █     █   █   █       █   █   █ █   █   █ █             █ █ █O█
███ █ █ █ █ █████ █ ███ ███ █ █ ███ █ █████ ███████ ███████ █ █ ███ ███ ███████ ███ █ █ █████ █████████ ███████ █ ███ █ █ ███ ███ ███████ █O█
█             █ █ █   █       █     █     █     █   █     █ █ █   █     █     █ █     █ █               █     █ █ █   █     █   █   █     █O█
█ █ █ █ █████ █ █ ███ █████████████████ ███████ █ ███ ███ █ █ ███ ███████ ███ █ █ █████ █████████ █████ █ ███ ███ █ ███████████ ███ █ █████O█
█ █   █ █   █   █   █ █               █     █   █   █   █     █   █       █   █       █ █         █         █   █ █   █       █   █ █   █OOO█
█ █ █ █ █ █ ███ █ ███ █ ███████ █████ █ █ ███ █████ █ █ ███████ ███ ███ █ █ ███████████ █ █████████ █████ █ ███ █ █████ █████ █ █ █ ███ █O███
█ █ █     █   █ █   █   █           █ █ █         █     █     █ █   █   █ █ █     █     █   █   █   █   █ █ █ █   █   █ █     █ █ █ █   █OOO█
█ █ █ █████ █ █ ███ █████████ █████ █ ███████████ ███████ ███ █ ███ █ ███ █ █ ███ █ ███████ █ █ █ ███ █ ███ █ ███ █ █ █ █ ███████ █ █ █████O█
█ █ █ █   █ █   █           █     █ █       █   █       █   █ █     █ █   █   █   █       █   █ █   █ █ █   █     █ █   █       █ █   █  OOO█
█ █ █ █ █ ███████ █████████ ███████ ███████ █ █ █ █ ███████ █ █ ███ █ █ █ █████ ███ █████ █████ █ ███ █ █ █ █ █████ ███████████ █ ███ █ █O█ █
█ █ █ █ █       █       █   █             █ █ █ █   █     █ █       █ █ █     █   █     █     █ █ █   █ █   █ █   █           █   █     █O█ █
█ █ ███ ███████ █ █████ █ ███ ███ ███████ █ █ █ █ ███ █ █ █ █████████ █ █████ ███ █████████ █ █ ███ ███ █ █ █ █ █ ███████████ ███████████O███
█ █   █ █ █     █       █ █   █ █ █     █ █ █ █   █   █ █ █     █   █ █     █   █   █       █ █     █   █ █ █   █       █     █         █OOO█
█ ███ █ █ █ █████ █ █████ ███ █ █ █ █ █ █ █ █ █████ ███ ███████ ███ █ █████ █ █ █ █ █ █████████ ███████ ███ ███████ ███ █ █████ ███████ ███O█
█                 █ █     █   █ █   █ █ █ █ █ █   █ █ █     █   █   █     █ █ █                 █     █     █         █ █ █   █ █   █    OOO█
█ █ █ █ █ ███ █████ █ █████ ███ █████ █ █ █ ███ █ █ █ ███ ███ ███ ███████ █ ███ █████ ███████████ ███ ███████ ███████ ███ █ █ █ █ █ █ ███O███
█ █   █ █   █   █   █ █   █   █         █ █   █ █ █   █   █   █   █   █   █   █ █   █         █   █ █   █   █     █ █ █   █ █   █ █ █   █O  █
█ █████ ███ ███ █ ███ █ █ █ █ █ █████████ ███ █ █ ███ █ █ █ ███ █ █ █ █ ███ █ █ █ █ █████ █████ ███ ███ █ █ █████ █ █ █ ███ ███ █ █ █ ███O█ █
█ █     █     █ █     █ █ █ █ █     █       █   █ █   █ █     █ █ █ █   █ █ █   █ █ █   █ █   █   █     █ █       █ █ █ █   █   █ █ █ █  O█ █
█ █████ █████ █ █ ███ █ █ ███ █████ ███ █ █████ █ █ ███ █ ███ █ █ █ █████ █ █████ █ ███ █ █ █ ███ █ █████ █ ███████ █ █ ███ ███ █ █ ███ █O█ █
█     █   █   █ █   █   █   █ █   █     █ █   █ █     █           █       █       █       █ █       █     █       █   █   █   █ █ █      O█ █
█████ ███ █ ███ ███ █████ █ █ ███ ███████ █ █ █████████████████ ███████ █ ███████████ █ ███ ███████ █ █████ ███ ███ █████ ███ █ █ ███████O█ █
█   █     █   █ █   █     █   █   █     █   █ █     █         █ █       █         █   █ █   █     █ █     █   █ █   █   █   █ █ █ █ █    O  █
█ ███████████ ███ ███ ███ █████ ███ █ ███ █ █ █ ███ █ █████ █ █ █ ███ ███ ███ ███ █ █ ███ ███ ███ █ █ ███ ███ █ █ ███ █ ███ █ ███ █ █ ███O█ █
█       █     █   █     █     █     █   █ █ █   █   █   █   █     █         █ █     █   █   █   █ █ █ █   █ █ █       █        OOOOOOOOOOO  █
█ █ █████ █████ ███ █████ █████ ███████ █ █ █████ █████ █ █ █████████ █████ █ █████ ███ ███ ███ █ █ █ █ ███ █ █████████ ███████O█ █ █ █ █ ███
█ █ █     █   █   █   █   █     █     █   █ █   █ █     █ █         █ █   █ █ █   █   █   █ █   █ █ █ █ █     █       █ █     █O    █ █ █   █
█ █ █ █████ █ █ █ ███ █ ███ ███████ █ █████ ███ █ ███ ███████ █████ ███ █ ███ █ █ ███ ███ █ █ █████ █ █ ███ ███ █████ ███ █ █ █O█████ █ █ █ █
█ █   █     █   █ █   █   █ █       █     █ █   █     █     █   █       █     █ █   █   █   █     █ █ █   █   █ █   █       █ █O█     █ █   █
█ ███████ █████ █ ███ ███ █ █ █ █████████ █ █ █████████ ███ ███ ███████████████ ███ ███ █████ ███ █ █ ███ █████ █ █ █████████ █O█ █████ █ ███
█       █ █   █ █   █   █   █ █ █     █   █ █   █       █   █   █     █         █ █   █ █       █ █ █   █           █   █     █O█     █   █ █
███████ █ █ █ █████ ███ ███████ ███ ███ ███ ███ █ █████ ███ █ ███ ███ █ █████████ ███ █ █████████ █ █ █████████████ ███ █ █████O█████ █ ███ █
█ █     █ █ █       █ █   █     █   █   █ █ █   █     █   █   █   █   █ █   █       █ █ █       █ █ █ █     █   █       █ █OOOOO      █     █
█ █ ███████ █████ ███ ███ █ █████ █ █ ███ █ █ ███ █ █ ███ ███ █ ███ ███ █ ███ ███ █ █ █ █ █████ █ █ ███ ███ █ █ █████████ █O█████ ███ █████ █
█   █       █     █         █     █       █ █       █   █   █ █ █ █ █   █       █ █ █ █   █       █     █ █   █ █   █   █ █OOO█ █   █ █   █ █
█ ███ ███ █████ █ █ ███████ █ █ ███ █ ███ █ █████████ █ █ █ ███ █ █ █ ███████████ █ █ ███████████████ ███ █████ █ █ █ █ █ ███O█ ███ ███ █ ███
█ █     █       █ █ █         █ █   █   █ █           █ █ █       █               █ █ █   █   █       █           █   █ █ █OOO█   █     █   █
█ █ ███ █ ███████ █ █████ █████ █ █████ █ ███████ █████ █ ███████ █████████████████ █ █ █ █ █ █ █ ███ █ ███ █ █████████ █ █O█O███ █████████ █
█     █ █     █ █ █     █ █     █ █     █       █ █     █   █   █ █   █   █ █       █ █ █   █   █ █   █ █   █         █   █O█OOO█     █     █
███ █ █ █ █ █ █ █ █ █ █ █ █ █████ █ █ █████████ █ █ █████████ █ ███ █ ███ █ █ ███████ █ █████████ █ █████ ███████████ █████O███O█████ █ ███ █
█   █ █   █ █ █   █   █   █   █ █ █ █         █   █           █   █ █     █ █ █     █ █   █       █       █       █   █   █OOO█O█     █ █   █
███ █ ███ █ █ ███ ███████████ █ █ █ █████████ ███ ███████████████ █ █████ █ █ █ ███ █ ███ ███ █ █ █████████ █████ █ ███ █ █ █O█O█ █████ █████
█   █ █   █ █   █ █           █ █ █         █ █   █   █           █ █     █   █   █ █       █   █ █         █       █   █   █OOO  █OOO█     █
█ █ █ █ ███ ███ █ █ ███████████ █ █ ███████ █ █ ███ █ █ ███████ █ █ ███ █ █ █ ███ █ ███████ █ █ █ ███████ █ █ ███████ ███████O█████O█O█ ███ █
█   █ █ █   █   █ █   █     █   █   █     █ █ █     █ █     █ █ █   █   █ █ █   █ █     █ █   █ █       █ █ █     █   █   █  OOOOOOO█O      █
█ █ █ █ █ ███ ███ ███ █ ███ ███ ███ █ ███ ███ ███████ █ █ █ █ █ █████ █████ █ █ █ █ ███ █ ███ █████ ███ █ █ █████ █ █████ █ ███████O█O███ ███
█ █   █ █   █ █   █   █   █   █   █   █ █   █ █         █ █ █       █       █ █ █ █   █ █     █   █   █ █ █       █       █     █OOO█OOO█   █
█ █ ███ █████ █ ███ ███ █████ █ ███████ ███ █ █ █ █ ███ █ █ ███████ ███ ███████ █ ███ █ ███████ █ █ █ █ █ █ █████████████ █████ █O█████O███ █
█       █     █   █     █     █   █   █     █   █ █ █   █ █   █   █   █ █     █ █   █           █   █ █ █   █           █   █ █ █OOOOOOO█   █
█████████ ███████ ███████ █████ █ █ █ █ █████████ █ █ ███ ███ █ █████ █ ███ █ █ ███ ███████████████ █ █ █████ ███ █ ███████ █ █ █ █████O█ ███
█         █     █         █   █ █ █ █             █ █     █   █     █ █     █   █ █     █   █         █ █   █ █ █ █ █         █ █     █OOOOO█
███████ ███████ ███████ ███ █ ███ █ ███████████████ ███████ ███ █ ███ █████████ █ █████ █ █ █ ███████ █ █ █ █ █ █ ███ █ █████ █ █████ █ ███O█
█       █     █             █     █ █     █       █     █   █ █ █     █           █   █ █ █   █     █ █   █ █ █ █     █     █ █     █   █  O█
█ ███████ ███ ███████ █████ █ █████ █ ███ █ █████ █████ █ ███ █ ███████████ ███ ███ █ █ █ █████ ███ ███ █ █ █ █ █████████ █ █ █████ ███ █ █O█
█ █     █   █       █   █   █ █     █   █   █         █ █ █           █   █     █   █ █ █ █   █ █ █   █ █   █       █     █ █     █ █ █   █O█
█ █ ███ ███ ███████ █ ███ ███ █ █ █████ █████ █ █████ █ █ █ █ █ █ ███ █ █ ███████ ███ █ █ █ █ █ █ ███ ███ ███████ ███ █████ ███ ███ █ █ ███O█
█ █   █     █   █ █ █ █   █   █ █     █ █ █   █ █   █ █ █ █ █ █ █ █     █       █ █ █ █ █   █   █   █ █   █     █ █   █   █ █   █   █     █O█
█ █ █ ███████ █ █ █ ███ █ █████ █ █████ █ █ █████ █ ███ █ ███ █ █ █████████████ █ █ █ █ ███████████ █ █ ███ █ ███ █ █ █ █ ███ ███ ███ █ █ █O█
█ █ █ █   █   █   █     █ █   █   █     █ █       █   █ █ █   █ █ █   █   █     █ █ █ █ █   █       █ █     █ █   █     █       █ █   █   █O█
█ ███ █ █ ███ █████ █ █████ █ ███ █ █████ ███████████ █ █ █ █ █ █ █ █ █ █ █████ █ █ █ █ ███ █ ███ █ █ ███████ █ █████████████████ █████ ███O█
█   █ █ █     █     █ █     █   █ █     █           █   █ █ █ █ █ █ █   █     █ █ █     █   █   █   █ █   █   █         █   █     █   █   █O█
███ █ █ ███████ ███ █ █ █████ ███ █████ █████ ███ █ █████ █ ███ █ █ █████████ █ █ ███████ █████ █ ███ █ █ █ █ █████████ ███ █ █████ █ █ █ █O█
█               █ █   █ █         █         █ █   █   █   █ █   █ █   █   █   █ █     █       █ █       █   █     █   █     █   █   █   █  O█
█ ███ █ █████ █ █ █ ███ █ █ █████████ █████ █ █ █████ █ █ █ █ ███ ███ █ ███ ███ █ ███ ███ █ ███ █████████████████ █ █ █████ █ █ █ █████ █ █O█
█ █   █ █   █   █   █ █   █     █         █ █ █   █   █ █ █ █       █   █   █ █ █   █   █ █   █ █           █   █ █ █     █   █ █     █ █ █O█
█ ███ ███ █ █ ███ █ █ █████████ █ █████ ███ █ ███ █████ █ █ █ ███ █████ █ ███ █ ███████ █ ███ █ █ █████████ ███ █ █████ █████ █ █ ███ █ █ █O█
█       █ █ █ █   █     █   █ █ █     █ █   █ █ █       █       █ █     █ █ █   █       █   █ █ █   █     █   █         █   █ █ █ █   █   █O█
█ █ █ █ █ █ █ ███ █████ █ █ █ █ █████ ███ ███ █ █████████ █ █ ███ █ █████ █ █ ███ █████████ █ █ ███ █ █ ███ █ █████████ █ █ █ █ ███ ███████O█
█ █ █ █ █ █ █     █       █   █       █   █   █   █       █ █     █ █     █ █ █   █ █       █   █   █ █ █   █       █   █ █   █   █        O█
█ █ █ █ █ █ █████ █ █████ █ █████ █████ ███ ███ █ █ █ █ ███ ███████ █ █████ █ ███ █ █ ███████████ ███ ███ █ ███████ █████ ███████ █████████O█
█     █         █ █ █   █   █   █ █     █ █   █ █ █ █   █   █   █   █ █       █   █ █ █     █         █   █       █         █      OOOOOOOOO█
█ █ ███████████ █ █ █ █ █████ █ █ █ █████ ███ ███ █ █████ █████ █ ███ █ █████ █ ███ █ █ ███ █ ███████ █ █████████ █████████ █ █ ███O█████ ███
█ █       █     █           █     █ █     █ █     █   █ █     █ █   █ █ █   █   █         █   █ █   █ █   █   █   █         █ █   █O█   █   █
█ ███████ █ ███ █████ █████ █ █████ ███ █ █ █████ ███ █ █████ █ ███ █ ███ █ █████████████ █████ █ █ █████ █ █ █ ███ █████ █ █ ███ █O█ █ ███ █
█       █ █ █   █         █   █     █   █   █     █   █   █   █ █   █     █                     █ █ █   █ █ █   █   █         █   █O  █   █ █
█████ ███ █ █████ █████████████ █████ ███████ █████ ███ █ █ ███ █ █████████████████████████ █████ █ █ █ █ █ ███████ █ ███████████ █O█████ █ █
█   █ █   █   █   █   █         █OOOOOOOOOOO█   █   █                     █   █         █   █     █   █   █ █ █     █       █    OOO        █
█ ███ █ █████ █ ███ █ █ █████████O█████████O█ ███ ███████████ ███ █████████ █ █ ███ ███ █████ ███████████ █ █ █ █ ███████ ███ █ █O█O█ █ ███ █
█     █ █   █   █     █ █     █OOO█       █O█ █   █       █   █   █         █   █             █     █     █ █   █       █ █      OOO      █ █
█ █ ███ █ █ █ ███████ █ █████ █O█████ ███ █O█ █ ███ █████ █ ███ ███ █████████████ ███ █████████ ███ █ ███ █ ███████████ ███ ███ █O███ ███ █ █
█ █   █ █ █ █       █ █ █     █OOOOO█ █   █O  █   █     █ █   █ █ █   █   █         █   █     █   █       █ █   █       █   █    O          █
███ █ █ █ █ ███████ █ █ █ █████████O█ █ ███O█████ █ █████ █████ █ ███ █ ███ █████████ █ █ ███ ███ █████ █ █ █ █ █ ███████ ███ ███O█████ █ █ █
█   █   █ █ █     █   █ █       █  O█ █ █  OOOOO█ █ █     █       █   █ █   █   █   █ █ █   █ █   █ █   █ █     █ █       █      O          █
█ █ █████ █ █ ███ ███ █ █ ███ ███ █O███ █ █████O█ █ █ ███ █ ███████ ███ █ ███ █ █ █ ███ █ ███ █ ███ █ █████████ █ █ ███████ ███ █O█████ █ █ █
█       █ █ █   █   █ █ █   █OOO█ █O    █ █OOOOO█   █ █   █ █   █   █   █ █   █ █ █       █   █     █ █       █ █     █     █   █O    █   █ █
█ █ ███ █ █ ███ █ ███ █ █████O█O█ █O█████ █O█████ ███ █ ███ ███ █ ███ ███ ███ ███ ███ █ █ █ ███████ █ █ █ ███ █ █ █████ █████ ███O███ █████ █
█ █           █ █ █   █     █O█O█ █O█     █OOO█ █   █ █     █   █ █           █   █   █   █     █   █   █     █ █   █   █   █ █  O█   █     █
█ █ █ █████ █ █ █ █ ███ ███ █O█O█ █O█ █ █ ███O█ █ ███ █ █████ █ █ ███████ █████ ███ █████ ███ █ █ ███████ █████ ███ █ ███ ███ █ █O█ ███████ █
█ █ █ █     █   █ █ █     █ █O█O█ █O█ █   █ █O█   █   █     █ █ █       █ █     █           █   █ █ █   █     █   █ █ █ █     █ █O█ █       █
█ ███ █ ███ █████ █ █ █ █ █ █O█O█ █O█ █████ █O█ ███ ███████ █ █ ███████ ███ █████ ███ ███████ ███ █ █ █ █████ █ █ ███ █ █ █████ █O█ █ █████ █
█ █   █ █   █   █   █   █ █ █O█OOOOO█ █OOOOO█O█   █ █     █   █   █   █   █ █   █   █   █   █   █ █ █ █ █     █ █ █   █ █ █     █O█ █ █   █ █
█ █ ███ █ ███ █ █ ███ █ ███ █O███████ █O███O█O███ █ █ ███ █ ███ ███ █ █ █ █ ███ ███ █ ███ █ █ █ █ █ █ █ █ ███ █ █ █ ███ █ ███ ███O█ █ █ █ █ █
█ █   █ █   █ █ █   █ █   █ █O    █   █OOO█OOO█   █ █   █ █     █   █ █           █ █ █   █   █ █   █ █   █ █ █ █       █     █  O█ █ █ █ █ █
█ ███ █ ███ █ █ █████ ███ █ █O███ █ █████O█████████ ███ █ █ █████ ███ ███████ █ ███ █ █ █████ █ █ ███ █████ █ █ ███████ ███████ █O█ █ █ █ █ █
█   █ █   █ █ █       █ █ █OOO█ █ █   █ █O█OOO    █     █   █ █   █   █     █   █   █ █ █   █ █   █   █   █     █OOOOO  █       █O█   █ █ █ █
███ █ ███ ███ █████████ █ █O█O█ █ █ █ █ █O█O█O███ ███████ █ █ █ ███ ███ ███ █ █ █ █████ █ ███ █████ █████ █ █████O███O█ ███ █████O█████ █ █ █
█ █ █   █   █ █     █   █  OOO  █ █ █ █  O█O█O█     █   █   █ █ █OOOOOOOOOOOOOOOOOOOOOOOOOOOOOOOOO█     █   █OOOOO█ █O█   █     █O      █ █ █
█ █ █ █ ███ █ █ ███ █ █ ███O█O█ █ █ █ ███O█O█O█████ █ █ ███ █ █ █O███████ █ █ █ ███████████O█████O█ ███ █ ███O█████ █O███ █ ███ █O███ ███ █ █
█                   █ █    OOO█   █ █   █O█O█OOOOO█   █ █     █ █OOO    █ █ █   █ █        OOOOOOOOOOOOOOOOO█O█      OOOOOOOOOOOOO        █ █
█ ███ █ ███████████ █ █████O█ ███ █ ███ █O█O█████O█████ ███ █ █ ███O███ █ █ █ █ █ █ ███ █ █ █ █ ███ █ █████O█O█ ███ █ █ █ █ █ █████ █ █████ █
█   █ █           █   █OOOOO█     █ █   █OOO█   █OOOOOOOOOOOOOOOOOOO█   █ █   █ █   █   █   █ █   █ █     █O█O█   █ █ █     █       █       █
███ █████ █ █████ █████O███ █ ███ ███ ███ █ █ █ █ ███████ █ █████████ ███ ███ █ ███ █ ███ ███████ ███████ █O█O█████ █ █████ █████ ███ ███ █ █
█OOOOOOOOOOOOOOOOOOOOOOO█   █   █     █ █     █ █       █   █       █ █     █ █     █ █   █       █     █ █OOO█   █ █         █   █   █ █   █
█O█ █ █ █ █ █ █ █████████ █ ███ ███████ █ ███████████ █ ███ █ █████ █ █ █ ███ █ ███ █ █ ███ ███████ ███ █ ███ █ █ █ ███████ █ █████ █ █ █████
█O█ █ █ █ █ █ █   █   █   █   █   █     █ █         █ █   █ █ █   █ █ █ █     █                           █   █ █     █         █   █   █   █
█O█ █ █ ███ █ █████ █ █ █ █ █ ███ █ ███ █ █ ███ ███ █████ █ █ █ █ █ █ █ █████ █ ███ ███████ █ █ ███████████ █ █ █████ ███ █ ███ █ ███ █ █ █ █
█O    █     █       █       █     █   █     █             █   █ █     █                     █ █                 █         █   █       █   █ █
█████████████████████████████████████████████████████████████████████████████████████████████████████████████████████████████████████████████
